############################
#                          ###
#                           e#
###  ##  ##  ##  ##  ##  #####
#pp  pp  pp  pp  pp  pp  pp#
###  ##  ##  ##  ##  ##  ###
#pp  pp  pp  pp  pp  pp  pp#
###  ##  ##  ##  ##  ##  ###
#pp  pp  pp  pp  pp  pp  pp#
###  ##  ##  ##  ##  ##  ###
#pp  pp  pp  pp  pp  pp  pp#
############################